country_code,game_year,BRONZE,GOLD,SILVER,total_medals
AFG,2008,1,0,0,1
AFG,2012,1,0,0,1
AHO,1988,0,0,1,1
ALG,1984,2,0,0,2
ALG,1992,1,1,0,2
ALG,1996,1,2,0,3
ALG,2000,3,1,1,5
ALG,2008,1,0,1,2
ALG,2012,0,1,0,1
ALG,2016,0,0,2,2
ANZ,1908,2,1,2,5
ANZ,1912,3,2,2,7
ARG,1924,2,1,3,6
ARG,1928,1,3,3,7
ARG,1932,0,3,1,4
ARG,1936,4,2,2,8
ARG,1948,1,3,3,7
ARG,1952,2,2,2,6
ARG,1956,1,0,1,2
ARG,1960,1,0,1,2
ARG,1964,0,0,1,1
ARG,1968,2,0,0,2
ARG,1972,0,0,1,1
ARG,1988,1,0,1,2
ARG,1992,2,0,0,2
ARG,1996,1,0,2,3
ARG,2000,3,0,2,5
ARG,2004,6,2,0,8
ARG,2008,5,3,0,8
ARG,2012,3,1,1,5
ARG,2016,0,4,1,5
ARG,2020,2,0,1,3
ARM,1996,0,1,1,2
ARM,2000,1,0,0,1
ARM,2008,4,0,1,5
ARM,2012,1,0,1,2
ARM,2016,0,1,3,4
ARM,2020,2,0,2,4
AUS,1896,0,2,0,2
AUS,1900,3,2,0,5
AUS,1904,1,0,3,4
AUS,1920,1,0,2,3
AUS,1924,2,3,1,6
AUS,1928,1,1,2,4
AUS,1932,1,3,1,5
AUS,1936,1,0,0,1
AUS,1948,5,2,6,13
AUS,1952,3,7,2,12
AUS,1956,16,14,9,39
AUS,1960,6,8,8,22
AUS,1964,10,6,2,18
AUS,1968,5,5,7,17
AUS,1972,2,9,7,18
AUS,1976,5,0,1,6
AUS,1980,5,2,2,9
AUS,1984,14,4,8,26
AUS,1988,7,3,6,16
AUS,1992,13,8,9,30
AUS,1994,1,0,0,1
AUS,1996,29,11,11,51
AUS,1998,1,0,0,1
AUS,2000,20,20,29,69
AUS,2002,0,2,0,2
AUS,2004,20,19,17,56
AUS,2006,1,1,0,2
AUS,2008,17,18,17,52
AUS,2010,0,2,1,3
AUS,2012,13,10,17,40
AUS,2014,1,0,2,3
AUS,2016,12,8,14,34
AUS,2018,1,0,2,3
AUS,2020,23,19,8,50
AUS,2022,1,1,2,4
AUT,1896,2,2,1,5
AUT,1900,3,0,3,6
AUT,1904,1,1,1,3
AUT,1908,1,0,0,1
AUT,1912,2,0,3,5
AUT,1924,1,3,4,8
AUT,1928,4,2,4,10
AUT,1932,3,2,2,7
AUT,1936,4,5,7,16
AUT,1948,7,2,3,12
AUT,1952,4,2,5,11
AUT,1956,8,5,3,16
AUT,1960,3,2,4,9
AUT,1964,3,5,6,14
AUT,1968,7,3,7,17
AUT,1972,4,1,3,8
AUT,1976,4,2,2,8
AUT,1980,4,4,5,13
AUT,1984,2,1,1,4
AUT,1988,2,4,5,11
AUT,1992,8,6,10,24
AUT,1994,4,2,3,9
AUT,1996,2,0,1,3
AUT,1998,9,3,5,17
AUT,2000,0,3,1,4
AUT,2002,10,3,4,17
AUT,2004,1,3,4,8
AUT,2006,7,10,7,24
AUT,2008,2,0,1,3
AUT,2010,6,5,6,17
AUT,2014,5,4,9,18
AUT,2016,2,0,0,2
AUT,2018,6,5,4,15
AUT,2020,5,1,1,7
AUT,2022,5,7,7,19
AZE,1996,0,0,1,1
AZE,2000,1,2,0,3
AZE,2004,4,1,0,5
AZE,2008,4,1,1,6
AZE,2012,6,2,2,10
AZE,2016,10,1,7,18
AZE,2020,4,0,3,7
BAH,1956,2,0,0,2
BAH,1964,0,2,0,2
BAH,1992,1,0,0,1
BAH,1996,0,0,1,1
BAH,2000,1,2,0,3
BAH,2004,1,1,0,2
BAH,2008,1,0,1,2
BAH,2012,0,1,0,1
BAH,2016,1,1,0,2
BAH,2020,0,2,0,2
BAR,2000,1,0,0,1
BDI,1996,0,1,0,1
BDI,2016,0,0,1,1
BEL,1900,4,5,7,16
BEL,1908,2,1,5,8
BEL,1912,3,2,1,6
BEL,1920,11,14,11,36
BEL,1924,4,3,7,14
BEL,1928,3,0,1,4
BEL,1936,2,0,0,2
BEL,1948,3,4,3,10
BEL,1952,0,2,3,5
BEL,1956,0,0,2,2
BEL,1960,2,0,2,4
BEL,1964,1,2,0,3
BEL,1968,2,0,1,3
BEL,1972,0,0,2,2
BEL,1976,3,0,3,6
BEL,1980,0,1,0,1
BEL,1984,2,1,2,5
BEL,1988,2,0,0,2
BEL,1992,2,0,1,3
BEL,1996,2,2,2,6
BEL,1998,1,0,0,1
BEL,2000,4,0,3,7
BEL,2004,2,1,0,3
BEL,2008,0,2,0,2
BEL,2012,2,0,1,3
BEL,2016,2,2,2,6
BEL,2018,0,0,1,1
BEL,2020,3,3,1,7
BEL,2022,1,1,0,2
BER,1976,1,0,0,1
BER,2020,0,1,0,1
BLR,1994,0,0,2,2
BLR,1996,8,1,6,15
BLR,1998,2,0,0,2
BLR,2000,11,3,3,17
BLR,2002,1,0,0,1
BLR,2004,8,2,5,15
BLR,2006,0,0,1,1
BLR,2008,9,4,4,17
BLR,2010,1,1,1,3
BLR,2012,3,3,7,13
BLR,2014,1,5,0,6
BLR,2016,4,1,4,9
BLR,2018,0,2,1,3
BLR,2020,3,1,3,7
BLR,2022,0,0,2,2
BOH,1900,1,0,1,2
BOH,1908,2,0,0,2
BOT,2012,0,0,1,1
BOT,2020,1,0,0,1
BRA,1920,1,1,1,3
BRA,1948,1,0,0,1
BRA,1952,2,1,0,3
BRA,1956,0,1,0,1
BRA,1960,2,0,0,2
BRA,1964,1,0,0,1
BRA,1968,3,0,1,4
BRA,1972,2,0,0,2
BRA,1976,3,0,0,3
BRA,1980,2,4,0,6
BRA,1984,2,1,5,8
BRA,1988,5,1,2,8
BRA,1992,0,2,1,3
BRA,1996,10,5,4,19
BRA,2000,8,0,8,16
BRA,2004,3,7,3,13
BRA,2008,12,3,6,21
BRA,2012,11,3,6,20
BRA,2016,6,9,8,23
BRA,2020,9,8,6,23
BRN,2012,0,1,0,1
BRN,2016,0,1,1,2
BRN,2020,0,0,1,1
BUL,1952,1,0,0,1
BUL,1956,1,1,3,5
BUL,1960,3,1,3,7
BUL,1964,2,3,5,10
BUL,1968,3,2,4,9
BUL,1972,6,6,10,22
BUL,1976,7,8,9,24
BUL,1980,20,8,16,44
BUL,1988,14,10,14,38
BUL,1992,7,3,7,17
BUL,1996,6,3,7,16
BUL,1998,0,1,0,1
BUL,2000,2,5,6,13
BUL,2002,2,0,1,3
BUL,2004,9,2,1,12
BUL,2006,0,0,1,1
BUL,2008,3,1,1,5
BUL,2012,1,0,2,3
BUL,2016,2,0,1,3
BUL,2020,2,3,1,6
BUR,2020,1,0,0,1
CAN,1900,1,1,0,2
CAN,1904,1,4,1,6
CAN,1908,11,3,3,17
CAN,1912,3,3,2,8
CAN,1920,3,3,3,9
CAN,1924,1,1,3,5
CAN,1928,7,5,5,17
CAN,1932,14,3,6,23
CAN,1936,6,1,3,10
CAN,1948,4,2,1,7
CAN,1952,1,2,1,4
CAN,1956,4,2,3,9
CAN,1960,1,3,2,6
CAN,1964,2,3,4,9
CAN,1968,2,2,4,8
CAN,1972,3,0,3,6
CAN,1976,7,1,6,14
CAN,1980,1,0,1,2
CAN,1984,19,13,23,55
CAN,1988,10,4,4,18
CAN,1992,11,10,8,29
CAN,1994,5,3,6,14
CAN,1996,9,4,11,24
CAN,1998,4,7,5,16
CAN,2000,8,4,4,16
CAN,2002,7,8,3,18
CAN,2004,4,3,7,14
CAN,2006,7,7,12,26
CAN,2008,9,3,10,22
CAN,2010,5,16,8,29
CAN,2012,12,2,6,20
CAN,2014,5,11,11,27
CAN,2016,16,4,4,24
CAN,2018,12,14,8,34
CAN,2020,13,7,7,27
CAN,2022,15,4,8,27
CHI,1928,0,0,1,1
CHI,1952,0,0,2,2
CHI,1956,2,0,2,4
CHI,1988,0,0,1,1
CHI,2000,1,0,0,1
CHI,2004,1,3,0,4
CHI,2008,0,0,1,1
CHN,1984,9,15,8,32
CHN,1988,12,6,12,30
CHN,1992,19,18,27,64
CHN,1994,2,0,1,3
CHN,1996,14,19,25,58
CHN,1998,2,0,6,8
CHN,2000,15,34,21,70
CHN,2002,5,2,2,9
CHN,2004,15,41,18,74
CHN,2006,6,2,5,13
CHN,2008,34,54,25,113
CHN,2010,4,6,3,13
CHN,2012,23,45,34,102
CHN,2014,2,3,4,9
CHN,2016,29,31,19,79
CHN,2018,2,1,7,10
CHN,2020,19,46,39,104
CHN,2022,2,10,4,16
CIV,1984,0,0,1,1
CIV,2016,1,1,0,2
CIV,2020,1,0,0,1
CMR,1968,0,0,1,1
CMR,1984,1,0,0,1
CMR,2000,0,1,0,1
CMR,2004,0,1,0,1
CMR,2008,0,1,0,1
CMR,2012,1,0,0,1
COL,1972,2,0,1,3
COL,1984,0,0,1,1
COL,1988,1,0,0,1
COL,1992,1,0,0,1
COL,2000,0,1,0,1
COL,2004,2,0,0,2
COL,2008,1,0,2,3
COL,2012,5,1,3,9
COL,2016,3,3,2,8
COL,2020,1,0,4,5
CRC,1988,0,0,1,1
CRC,1996,0,1,0,1
CRC,2000,2,0,0,2
CRO,1992,3,0,1,4
CRO,1996,0,1,1,2
CRO,2000,1,1,0,2
CRO,2002,0,3,1,4
CRO,2004,3,1,3,7
CRO,2006,0,1,2,3
CRO,2008,3,0,2,5
CRO,2010,1,0,2,3
CRO,2012,2,3,1,6
CRO,2014,0,0,1,1
CRO,2016,2,7,3,12
CRO,2020,2,5,4,11
CUB,1900,0,1,1,2
CUB,1904,0,3,0,3
CUB,1948,0,0,2,2
CUB,1964,0,0,1,1
CUB,1968,0,0,4,4
CUB,1972,4,3,1,8
CUB,1976,3,6,4,13
CUB,1980,5,8,7,20
CUB,1992,11,14,6,31
CUB,1996,8,9,8,25
CUB,2000,7,11,12,30
CUB,2004,11,9,8,28
CUB,2008,17,3,10,30
CUB,2012,7,5,3,15
CUB,2016,4,5,2,11
CUB,2020,5,8,3,16
CYP,2012,0,0,1,1
CZE,1996,4,4,5,13
CZE,1998,1,1,1,3
CZE,2000,4,2,3,9
CZE,2002,0,1,2,3
CZE,2004,6,1,3,10
CZE,2006,1,1,2,4
CZE,2008,1,3,4,8
CZE,2010,4,2,0,6
CZE,2012,4,4,4,12
CZE,2014,2,2,4,8
CZE,2016,9,1,2,12
CZE,2018,3,2,2,7
CZE,2020,4,5,4,13
CZE,2022,1,1,0,2
DEN,1896,3,1,2,6
DEN,1900,2,1,3,6
DEN,1908,3,0,2,5
DEN,1912,5,1,6,12
DEN,1920,1,3,9,13
DEN,1924,2,2,6,10
DEN,1928,2,3,1,6
DEN,1932,4,0,3,7
DEN,1936,3,0,3,6
DEN,1948,8,5,9,22
DEN,1952,3,3,1,7
DEN,1956,1,1,1,3
DEN,1960,1,2,4,7
DEN,1964,4,2,1,7
DEN,1968,4,1,4,9
DEN,1972,0,1,0,1
DEN,1976,2,1,0,3
DEN,1980,2,2,2,6
DEN,1984,3,0,3,6
DEN,1988,1,3,1,5
DEN,1992,5,1,2,8
DEN,1996,1,4,1,6
DEN,1998,0,0,1,1
DEN,2000,1,2,3,6
DEN,2004,7,2,1,10
DEN,2008,4,3,3,10
DEN,2012,5,3,5,13
DEN,2016,9,2,7,18
DEN,2020,5,4,5,14
DJI,1988,1,0,0,1
DOM,1984,1,0,0,1
DOM,2004,0,1,0,1
DOM,2008,0,1,1,2
DOM,2012,0,1,1,2
DOM,2016,1,0,0,1
DOM,2020,2,0,3,5
ECU,1996,0,1,0,1
ECU,2008,0,0,1,1
ECU,2020,0,2,1,3
EGY,1928,1,2,1,4
EGY,1936,2,2,1,5
EGY,1948,1,2,2,5
EGY,1952,1,0,0,1
EGY,1984,0,0,1,1
EGY,2004,3,1,1,5
EGY,2008,2,0,0,2
EGY,2012,1,0,3,4
EGY,2016,3,0,0,3
EGY,2020,4,1,1,6
ERI,2004,1,0,0,1
ESP,1900,0,2,0,2
ESP,1920,0,0,2,2
ESP,1928,0,1,0,1
ESP,1932,1,0,0,1
ESP,1948,0,0,1,1
ESP,1952,0,0,1,1
ESP,1960,1,0,0,1
ESP,1972,1,1,0,2
ESP,1976,0,0,3,3
ESP,1980,3,2,4,9
ESP,1984,3,2,3,8
ESP,1988,2,1,2,5
ESP,1992,3,16,8,27
ESP,1996,7,7,6,20
ESP,2000,6,3,3,12
ESP,2004,6,4,14,24
ESP,2008,3,7,15,25
ESP,2012,6,4,11,21
ESP,2016,6,9,4,19
ESP,2018,2,0,0,2
ESP,2020,7,4,8,19
ESP,2022,0,0,1,1
EST,1920,0,1,2,3
EST,1924,4,1,1,6
EST,1928,2,2,1,5
EST,1936,3,2,2,7
EST,1992,2,1,0,3
EST,2000,2,1,0,3
EST,2002,1,1,1,3
EST,2004,2,0,1,3
EST,2006,0,3,0,3
EST,2008,0,1,2,3
EST,2010,0,0,1,1
EST,2012,1,0,1,2
EST,2016,1,0,0,1
EST,2020,1,1,0,2
EST,2022,1,0,0,1
ETH,1960,0,1,0,1
ETH,1964,0,1,0,1
ETH,1968,0,1,1,2
ETH,1972,2,0,0,2
ETH,1980,2,2,0,4
ETH,1992,2,1,0,3
ETH,1996,1,2,0,3
ETH,2000,3,4,1,8
ETH,2004,2,2,3,7
ETH,2008,1,4,2,7
ETH,2012,2,3,2,7
ETH,2016,5,1,2,8
ETH,2020,2,1,1,4
EUN,1992,39,57,45,141
FIJ,2016,0,1,0,1
FIJ,2020,1,1,0,2
FIN,1908,3,1,1,5
FIN,1912,9,9,8,26
FIN,1920,9,16,10,35
FIN,1924,13,18,18,49
FIN,1928,9,10,9,28
FIN,1932,13,6,9,28
FIN,1936,9,8,8,25
FIN,1948,9,9,10,28
FIN,1952,15,8,7,30
FIN,1956,12,6,4,22
FIN,1960,7,3,4,14
FIN,1964,5,6,4,15
FIN,1968,3,2,4,9
FIN,1972,5,3,5,13
FIN,1976,1,6,6,13
FIN,1980,8,4,6,18
FIN,1984,12,8,5,25
FIN,1988,4,5,2,11
FIN,1992,5,4,3,12
FIN,1994,5,0,1,6
FIN,1996,1,1,2,4
FIN,1998,6,2,4,12
FIN,2000,1,3,1,5
FIN,2002,1,4,2,7
FIN,2004,0,0,2,2
FIN,2006,4,0,6,10
FIN,2008,2,1,2,5
FIN,2010,4,0,1,5
FIN,2012,1,0,2,3
FIN,2014,1,2,4,7
FIN,2016,1,0,0,1
FIN,2018,4,1,1,6
FIN,2020,2,0,0,2
FIN,2022,4,2,3,9
FRA,1896,2,5,4,11
FRA,1900,37,28,38,103
FRA,1904,0,0,1,1
FRA,1908,9,6,5,20
FRA,1912,5,8,4,17
FRA,1920,16,10,19,45
FRA,1924,15,14,18,47
FRA,1928,5,8,10,23
FRA,1932,4,13,5,22
FRA,1936,8,7,5,20
FRA,1948,18,12,7,37
FRA,1952,7,5,6,18
FRA,1956,6,4,5,15
FRA,1960,5,1,2,8
FRA,1964,6,4,13,23
FRA,1968,7,12,6,25
FRA,1972,10,2,6,18
FRA,1976,5,2,3,10
FRA,1980,4,6,5,15
FRA,1984,20,5,9,34
FRA,1988,8,9,4,21
FRA,1992,19,12,11,42
FRA,1994,4,0,1,5
FRA,1996,18,16,7,41
FRA,1998,6,2,1,9
FRA,2000,14,14,14,42
FRA,2002,2,5,5,12
FRA,2004,14,12,10,36
FRA,2006,4,3,2,9
FRA,2008,22,7,16,45
FRA,2010,6,2,3,11
FRA,2012,14,11,13,38
FRA,2014,7,4,4,15
FRA,2016,16,11,18,45
FRA,2018,7,5,5,17
FRA,2020,13,11,13,37
FRA,2022,2,6,7,15
FRG,1968,15,8,15,38
FRG,1972,19,17,14,50
FRG,1976,23,14,19,56
FRG,1980,3,0,2,5
FRG,1984,26,20,21,67
FRG,1988,19,13,18,50
GAB,2012,0,0,1,1
GBR,1896,2,2,3,7
GBR,1900,10,17,8,35
GBR,1904,0,1,1,2
GBR,1908,43,60,57,160
GBR,1912,17,11,16,44
GBR,1920,14,17,17,48
GBR,1924,15,10,15,40
GBR,1928,8,3,12,23
GBR,1932,5,5,9,19
GBR,1936,3,6,8,17
GBR,1948,8,6,15,29
GBR,1952,8,2,2,12
GBR,1956,10,5,7,22
GBR,1960,12,2,6,20
GBR,1964,2,6,13,21
GBR,1968,3,6,5,14
GBR,1972,9,5,6,20
GBR,1976,5,5,7,17
GBR,1980,10,6,7,23
GBR,1984,22,7,11,40
GBR,1988,9,7,10,26
GBR,1992,12,6,3,21
GBR,1994,3,0,0,3
GBR,1996,6,2,10,18
GBR,1998,1,0,0,1
GBR,2000,8,11,12,31
GBR,2002,1,1,0,2
GBR,2004,15,9,13,37
GBR,2006,0,0,1,1
GBR,2008,21,21,14,56
GBR,2010,0,1,0,1
GBR,2012,20,33,24,77
GBR,2014,3,1,1,5
GBR,2016,19,30,26,75
GBR,2018,4,1,0,5
GBR,2020,22,26,23,71
GBR,2022,0,1,1,2
GDR,1968,9,12,11,32
GDR,1972,33,27,28,88
GDR,1976,35,51,34,120
GDR,1980,52,61,48,161
GDR,1984,7,10,10,27
GDR,1988,37,49,48,134
GEO,1996,2,0,0,2
GEO,2000,6,0,0,6
GEO,2004,0,2,2,4
GEO,2008,2,3,2,7
GEO,2012,3,1,2,6
GEO,2016,4,2,1,7
GEO,2020,1,2,5,8
GER,1896,2,6,5,13
GER,1900,2,4,3,9
GER,1904,6,4,5,15
GER,1908,6,4,5,15
GER,1912,7,6,13,26
GER,1928,16,11,7,34
GER,1932,7,3,13,23
GER,1936,29,38,29,96
GER,1952,18,5,9,32
GER,1956,7,6,11,24
GER,1960,12,16,25,53
GER,1964,24,14,26,64
GER,1992,35,50,37,122
GER,1994,9,9,7,25
GER,1996,29,22,20,71
GER,1998,10,13,9,32
GER,2000,31,15,18,64
GER,2002,9,14,17,40
GER,2004,20,15,22,57
GER,2006,6,13,13,32
GER,2008,17,17,15,49
GER,2010,9,12,15,36
GER,2012,14,15,20,49
GER,2014,6,9,6,21
GER,2016,17,20,11,48
GER,2018,8,18,10,36
GER,2020,21,10,15,46
GER,2022,6,16,13,35
GHA,1960,0,0,1,1
GHA,1964,1,0,0,1
GHA,1972,1,0,0,1
GHA,1992,1,0,0,1
GHA,2020,1,0,0,1
GRE,1896,20,10,19,49
GRE,1904,1,1,0,2
GRE,1908,1,0,3,4
GRE,1912,1,1,0,2
GRE,1920,0,0,1,1
GRE,1956,1,0,0,1
GRE,1960,0,1,0,1
GRE,1968,1,0,0,1
GRE,1972,0,0,2,2
GRE,1980,2,1,0,3
GRE,1984,1,0,1,2
GRE,1988,1,0,0,1
GRE,1992,0,2,0,2
GRE,1996,0,4,4,8
GRE,2000,3,4,6,13
GRE,2004,5,8,6,19
GRE,2008,1,0,3,4
GRE,2012,3,0,0,3
GRE,2016,3,3,1,7
GRE,2020,1,2,1,4
GRN,2012,0,1,0,1
GRN,2016,0,0,1,1
GRN,2020,1,0,0,1
GUA,2012,0,0,1,1
GUY,1980,1,0,0,1
HAI,1924,1,0,0,1
HAI,1928,0,0,1,1
HKG,1996,0,1,0,1
HKG,2004,0,0,2,2
HKG,2012,1,0,0,1
HKG,2020,3,1,2,6
HUN,1896,3,2,1,6
HUN,1900,2,1,2,5
HUN,1904,1,2,1,4
HUN,1908,2,3,4,9
HUN,1912,3,3,2,8
HUN,1924,4,2,3,9
HUN,1928,0,4,5,9
HUN,1932,7,6,4,17
HUN,1936,7,10,1,18
HUN,1948,12,10,7,29
HUN,1952,17,16,9,42
HUN,1956,11,10,10,31
HUN,1960,9,6,9,24
HUN,1964,5,10,7,22
HUN,1968,12,10,13,35
HUN,1972,16,6,14,36
HUN,1976,16,4,6,26
HUN,1980,17,8,13,38
HUN,1988,7,11,6,24
HUN,1992,8,11,12,31
HUN,1996,11,8,4,23
HUN,2000,4,10,7,21
HUN,2004,4,9,6,19
HUN,2008,3,4,5,12
HUN,2012,6,9,5,20
HUN,2016,4,9,3,16
HUN,2018,0,1,0,1
HUN,2020,8,6,7,21
HUN,2022,2,1,0,3
INA,1988,0,0,1,1
INA,1992,1,2,3,6
INA,1996,3,2,1,6
INA,2000,2,2,4,8
INA,2004,3,1,1,5
INA,2008,4,2,2,8
INA,2012,1,0,2,3
INA,2016,0,2,2,4
INA,2020,3,2,1,6
IND,1900,0,0,2,2
IND,1928,0,1,0,1
IND,1932,0,1,0,1
IND,1936,0,1,0,1
IND,1948,0,1,0,1
IND,1952,1,1,0,2
IND,1956,0,1,0,1
IND,1960,0,0,1,1
IND,1964,0,1,0,1
IND,1968,1,0,0,1
IND,1972,1,0,0,1
IND,1980,0,1,0,1
IND,1996,1,0,0,1
IND,2000,1,0,0,1
IND,2004,0,0,1,1
IND,2008,2,1,0,3
IND,2012,4,0,2,6
IND,2016,1,0,1,2
IND,2020,4,1,2,7
IOA,1992,2,0,1,3
IOA,2016,1,1,0,2
IRI,1948,1,0,0,1
IRI,1952,4,0,3,7
IRI,1956,1,2,2,5
IRI,1960,3,0,1,4
IRI,1964,2,0,0,2
IRI,1968,2,2,1,5
IRI,1972,1,0,2,3
IRI,1976,1,0,1,2
IRI,1988,0,0,1,1
IRI,1992,2,0,1,3
IRI,1996,1,1,1,3
IRI,2000,1,3,0,4
IRI,2004,2,2,2,6
IRI,2008,1,1,0,2
IRI,2012,1,6,6,13
IRI,2016,4,3,1,8
IRI,2020,2,3,2,7
IRL,1928,0,1,0,1
IRL,1932,0,2,0,2
IRL,1952,0,0,1,1
IRL,1956,3,1,1,5
IRL,1964,1,0,0,1
IRL,1980,1,0,2,3
IRL,1984,0,0,1,1
IRL,1992,0,1,1,2
IRL,1996,1,3,0,4
IRL,2000,0,0,1,1
IRL,2008,2,0,1,3
IRL,2012,4,1,1,6
IRL,2016,0,0,3,3
IRL,2020,2,3,0,5
IRQ,1960,1,0,0,1
ISL,1956,0,0,1,1
ISL,1984,1,0,0,1
ISL,2000,1,0,0,1
ISL,2008,0,0,1,1
ISR,1992,1,0,1,2
ISR,1996,1,0,0,1
ISR,2000,1,0,0,1
ISR,2004,1,1,0,2
ISR,2008,1,0,0,1
ISR,2016,2,0,0,2
ISR,2020,2,2,0,4
ISV,1988,0,0,1,1
ITA,1900,0,3,2,5
ITA,1908,0,2,2,4
ITA,1912,2,3,1,6
ITA,1920,5,13,6,24
ITA,1924,5,8,3,16
ITA,1928,7,7,5,19
ITA,1932,12,12,12,36
ITA,1936,5,8,9,22
ITA,1948,9,10,11,30
ITA,1952,6,10,9,25
ITA,1956,9,10,10,29
ITA,1960,14,14,11,39
ITA,1964,12,11,12,35
ITA,1968,10,8,4,22
ITA,1972,11,8,5,24
ITA,1976,5,3,9,17
ITA,1980,5,8,6,19
ITA,1984,13,16,6,35
ITA,1988,6,8,5,19
ITA,1992,14,10,11,35
ITA,1994,9,8,6,23
ITA,1996,12,15,11,38
ITA,1998,2,3,6,11
ITA,2000,15,14,9,38
ITA,2002,6,4,4,14
ITA,2004,12,10,12,34
ITA,2006,8,5,0,13
ITA,2008,11,8,9,28
ITA,2010,3,1,1,5
ITA,2012,11,8,10,29
ITA,2014,6,0,2,8
ITA,2016,9,8,14,31
ITA,2018,5,3,2,10
ITA,2020,21,12,10,43
ITA,2022,8,3,8,19
JAM,1948,0,1,2,3
JAM,1952,0,2,3,5
JAM,1968,0,0,1,1
JAM,1972,1,0,0,1
JAM,1976,0,1,1,2
JAM,1980,3,0,0,3
JAM,1984,2,0,1,3
JAM,1988,0,0,2,2
JAM,1992,1,0,3,4
JAM,1996,2,1,3,6
JAM,2000,3,0,6,9
JAM,2004,2,2,1,5
JAM,2008,1,5,4,10
JAM,2012,3,4,5,12
JAM,2016,2,6,3,11
JAM,2020,4,4,1,9
JOR,2016,0,1,0,1
JOR,2020,1,0,1,2
JPN,1920,0,0,3,3
JPN,1924,1,0,0,1
JPN,1928,1,2,2,5
JPN,1932,4,7,7,18
JPN,1936,8,6,4,18
JPN,1952,2,1,6,9
JPN,1956,5,4,11,20
JPN,1960,7,4,7,18
JPN,1964,8,16,5,29
JPN,1968,7,11,7,25
JPN,1972,9,14,9,32
JPN,1976,10,9,6,25
JPN,1980,0,0,1,1
JPN,1984,15,10,9,34
JPN,1988,9,4,3,16
JPN,1992,16,4,10,30
JPN,1994,2,1,2,5
JPN,1996,5,3,7,15
JPN,1998,4,5,1,10
JPN,2000,5,5,9,19
JPN,2002,1,0,1,2
JPN,2004,13,16,10,39
JPN,2006,0,1,0,1
JPN,2008,9,9,8,26
JPN,2010,2,0,3,5
JPN,2012,17,7,15,39
JPN,2014,3,1,4,8
JPN,2016,22,13,8,43
JPN,2018,4,4,5,13
JPN,2020,18,28,14,60
JPN,2022,9,3,6,18
KAZ,1994,0,1,2,3
KAZ,1996,4,3,4,11
KAZ,1998,2,0,0,2
KAZ,2000,0,3,4,7
KAZ,2004,3,1,4,8
KAZ,2008,4,2,3,9
KAZ,2010,0,0,1,1
KAZ,2012,6,3,2,11
KAZ,2014,1,0,0,1
KAZ,2016,10,3,5,18
KAZ,2018,1,0,0,1
KAZ,2020,8,0,0,8
KEN,1964,1,0,0,1
KEN,1968,2,3,4,9
KEN,1972,4,2,3,9
KEN,1984,2,1,0,3
KEN,1988,2,5,2,9
KEN,1992,2,2,4,8
KEN,1996,3,1,4,8
KEN,2000,2,2,3,7
KEN,2004,2,1,4,7
KEN,2008,6,6,4,16
KEN,2012,6,2,4,12
KEN,2016,1,6,6,13
KEN,2020,2,4,4,10
KGZ,2000,1,0,0,1
KGZ,2008,2,0,1,3
KGZ,2020,1,0,2,3
KOR,1948,2,0,0,2
KOR,1952,2,0,0,2
KOR,1956,1,0,1,2
KOR,1964,1,0,2,3
KOR,1968,1,0,1,2
KOR,1972,0,0,1,1
KOR,1976,4,1,1,6
KOR,1984,7,6,6,19
KOR,1988,12,13,10,35
KOR,1992,17,16,6,39
KOR,1994,1,4,1,6
KOR,1996,7,8,17,32
KOR,1998,2,3,1,6
KOR,2000,12,8,11,31
KOR,2002,0,2,2,4
KOR,2004,10,10,14,34
KOR,2006,2,6,3,11
KOR,2008,9,14,12,35
KOR,2010,2,6,6,14
KOR,2012,9,13,9,31
KOR,2014,2,3,3,8
KOR,2016,10,9,3,22
KOR,2018,4,5,8,17
KOR,2020,11,7,4,22
KOR,2022,2,2,5,9
KOS,2016,0,1,0,1
KOS,2020,0,2,0,2
KSA,2000,1,0,1,2
KSA,2012,1,0,0,1
KSA,2020,0,0,1,1
KUW,2000,1,0,0,1
KUW,2012,1,0,0,1
KUW,2020,1,0,0,1
LAT,1932,0,0,1,1
LAT,1936,1,0,1,2
LAT,1992,1,0,2,3
LAT,1996,0,0,1,1
LAT,2000,1,1,1,3
LAT,2004,0,0,4,4
LAT,2006,1,0,0,1
LAT,2008,1,1,1,3
LAT,2010,0,0,3,3
LAT,2012,2,1,0,3
LAT,2014,5,1,1,7
LAT,2018,2,0,0,2
LAT,2020,1,1,0,2
LAT,2022,1,0,0,1
LBN,1952,1,0,1,2
LBN,1972,0,0,1,1
LBN,1980,1,0,0,1
LIE,1976,2,0,0,2
LIE,1980,0,2,2,4
LIE,1984,2,0,0,2
LIE,1988,1,0,0,1
LIE,2018,1,0,0,1
LTU,1992,1,1,0,2
LTU,1996,1,0,0,1
LTU,2000,4,2,0,6
LTU,2004,0,1,2,3
LTU,2008,2,0,3,5
LTU,2012,3,2,0,5
LTU,2016,5,0,2,7
LTU,2020,0,0,1,1
LUX,1900,0,1,0,1
LUX,1920,0,0,1,1
LUX,1952,0,1,0,1
LUX,1992,0,0,2,2
MAR,1960,0,0,1,1
MAR,1984,0,2,0,2
MAR,1988,2,1,0,3
MAR,1992,1,1,1,3
MAR,1996,2,0,0,2
MAR,2000,4,0,1,5
MAR,2004,0,2,1,3
MAR,2008,1,0,1,2
MAR,2012,1,0,0,1
MAR,2016,1,0,0,1
MAR,2020,0,1,0,1
MAS,1992,2,0,0,2
MAS,1996,1,0,2,3
MAS,2008,0,0,1,1
MAS,2012,1,0,1,2
MAS,2016,1,0,7,8
MAS,2020,2,0,1,3
MDA,1996,1,0,2,3
MDA,2000,1,0,1,2
MDA,2008,1,0,0,1
MDA,2020,1,0,0,1
MEX,1932,0,0,2,2
MEX,1936,3,0,0,3
MEX,1948,2,2,1,5
MEX,1952,0,0,1,1
MEX,1956,1,1,0,2
MEX,1960,1,0,0,1
MEX,1964,1,0,0,1
MEX,1968,3,3,3,9
MEX,1972,0,0,1,1
MEX,1976,1,1,0,2
MEX,1980,3,0,1,4
MEX,1984,1,2,3,6
MEX,1988,2,0,0,2
MEX,1992,0,0,1,1
MEX,1996,1,0,0,1
MEX,2000,3,1,2,6
MEX,2004,1,0,3,4
MEX,2008,3,2,0,5
MEX,2012,4,1,5,10
MEX,2016,2,0,3,5
MEX,2020,6,0,0,6
MGL,1968,3,0,1,4
MGL,1972,0,0,1,1
MGL,1976,0,0,1,1
MGL,1980,2,0,2,4
MGL,1988,1,0,0,1
MGL,1992,2,0,0,2
MGL,1996,1,0,0,1
MGL,2004,1,0,0,1
MGL,2008,0,2,2,4
MGL,2012,3,0,2,5
MGL,2016,1,0,1,2
MGL,2020,3,0,1,4
MIX,1896,2,2,0,4
MIX,1900,8,8,7,23
MIX,1904,1,2,1,4
MKD,2000,1,0,0,1
MKD,2020,0,0,1,1
MNE,2012,0,0,1,1
MOZ,1996,1,0,0,1
MOZ,2000,0,1,0,1
MRI,2008,1,0,0,1
NAM,1992,0,0,2,2
NAM,1996,0,0,2,2
NAM,2020,0,0,1,1
NED,1900,3,0,2,5
NED,1908,2,0,0,2
NED,1912,3,0,0,3
NED,1920,6,4,3,13
NED,1924,7,5,1,13
NED,1928,4,7,9,20
NED,1932,0,2,5,7
NED,1936,8,5,5,18
NED,1948,10,5,2,17
NED,1952,0,0,8,8
NED,1960,3,0,2,5
NED,1964,4,3,7,14
NED,1968,4,6,8,18
NED,1972,4,7,4,15
NED,1976,6,1,4,11
NED,1980,3,1,3,7
NED,1984,6,5,3,14
NED,1988,8,6,4,18
NED,1992,10,3,7,20
NED,1994,3,0,1,4
NED,1996,11,4,6,21
NED,1998,2,5,4,11
NED,2000,4,12,11,27
NED,2002,0,3,5,8
NED,2004,10,4,9,23
NED,2006,4,3,2,9
NED,2008,4,8,6,18
NED,2010,3,4,1,8
NED,2012,9,6,6,21
NED,2014,9,8,7,24
NED,2016,5,9,7,21
NED,2018,6,8,6,20
NED,2020,17,10,14,41
NED,2022,4,8,5,17
NGR,1964,1,0,0,1
NGR,1972,1,0,0,1
NGR,1984,1,0,1,2
NGR,1992,1,0,3,4
NGR,1996,3,2,1,6
NGR,2000,0,1,2,3
NGR,2004,2,0,0,2
NGR,2008,3,0,2,5
NGR,2016,1,0,0,1
NGR,2020,1,0,1,2
NIG,1972,1,0,0,1
NIG,2016,0,0,1,1
NOR,1900,3,0,2,5
NOR,1904,0,2,0,2
NOR,1908,3,2,3,8
NOR,1912,5,4,1,10
NOR,1920,9,13,10,32
NOR,1924,9,9,9,27
NOR,1928,6,7,5,18
NOR,1932,3,3,4,10
NOR,1936,5,8,8,21
NOR,1948,6,5,7,18
NOR,1952,6,10,5,21
NOR,1956,3,3,1,7
NOR,1960,0,5,3,8
NOR,1964,6,3,6,15
NOR,1968,2,7,8,17
NOR,1972,6,4,7,17
NOR,1976,1,5,4,10
NOR,1980,6,1,3,10
NOR,1984,7,3,3,13
NOR,1988,2,2,7,11
NOR,1992,6,11,10,27
NOR,1994,5,10,11,26
NOR,1996,3,2,3,8
NOR,1998,5,10,10,25
NOR,2000,3,4,4,11
NOR,2002,7,13,5,25
NOR,2004,2,5,0,7
NOR,2006,9,2,9,20
NOR,2008,1,3,5,9
NOR,2010,6,10,8,24
NOR,2012,1,2,1,4
NOR,2014,10,12,5,27
NOR,2016,6,0,0,6
NOR,2018,13,15,14,42
NOR,2020,2,5,2,9
NOR,2022,13,17,9,39
NZL,1920,1,0,0,1
NZL,1924,1,0,0,1
NZL,1928,0,1,0,1
NZL,1932,0,0,2,2
NZL,1936,0,1,0,1
NZL,1952,2,1,0,3
NZL,1956,0,3,0,3
NZL,1960,1,2,0,3
NZL,1964,2,4,0,6
NZL,1968,2,1,0,3
NZL,1972,1,1,1,3
NZL,1976,1,2,1,4
NZL,1984,2,10,1,13
NZL,1988,9,4,4,17
NZL,1992,5,1,7,13
NZL,1996,1,3,2,6
NZL,2000,3,1,0,4
NZL,2004,0,4,2,6
NZL,2008,5,4,2,11
NZL,2012,7,9,3,19
NZL,2016,5,6,12,23
NZL,2018,2,0,0,2
NZL,2020,8,9,8,25
NZL,2022,0,2,1,3
OAR,2018,9,2,7,18
PAK,1956,0,0,1,1
PAK,1960,1,1,0,2
PAK,1964,0,0,1,1
PAK,1968,0,1,0,1
PAK,1972,0,0,1,1
PAK,1976,1,0,0,1
PAK,1984,0,1,0,1
PAK,1988,1,0,0,1
PAK,1992,1,0,0,1
PAN,1948,2,0,0,2
PAN,2008,0,1,0,1
PAR,2004,0,0,1,1
PER,1948,0,1,0,1
PER,1984,0,0,1,1
PER,1988,0,0,1,1
PER,1992,0,0,1,1
PHI,1928,1,0,0,1
PHI,1932,3,0,0,3
PHI,1936,1,0,0,1
PHI,1964,0,0,1,1
PHI,1988,1,0,0,1
PHI,1992,1,0,0,1
PHI,1996,0,0,1,1
PHI,2016,0,0,1,1
PHI,2020,1,1,2,4
POL,1924,1,0,1,2
POL,1928,3,1,1,5
POL,1932,5,2,1,8
POL,1936,4,0,3,7
POL,1948,1,0,0,1
POL,1952,1,1,2,4
POL,1956,5,1,4,10
POL,1960,13,4,7,24
POL,1964,10,7,6,23
POL,1968,11,5,2,18
POL,1972,11,8,5,24
POL,1976,13,7,7,27
POL,1980,15,3,15,33
POL,1988,10,2,6,18
POL,1992,11,3,7,21
POL,1996,5,7,5,17
POL,2000,4,7,7,18
POL,2002,1,0,1,2
POL,2004,6,4,2,12
POL,2006,1,0,1,2
POL,2008,2,4,6,12
POL,2010,2,1,3,6
POL,2012,9,3,1,13
POL,2014,1,4,1,6
POL,2016,7,3,3,13
POL,2018,1,1,0,2
POL,2020,5,4,7,16
POL,2022,1,0,0,1
POR,1924,1,0,0,1
POR,1928,1,0,0,1
POR,1936,1,0,0,1
POR,1948,1,0,2,3
POR,1952,2,0,0,2
POR,1960,0,0,2,2
POR,1976,0,0,2,2
POR,1984,2,1,0,3
POR,1988,0,1,0,1
POR,1996,2,1,0,3
POR,2000,2,0,0,2
POR,2004,1,0,2,3
POR,2008,0,1,1,2
POR,2012,0,0,2,2
POR,2016,1,0,0,1
POR,2020,2,1,1,4
PRK,1964,0,0,1,1
PRK,1972,3,1,1,5
PRK,1976,0,1,1,2
PRK,1980,2,0,3,5
PRK,1992,7,4,0,11
PRK,1996,2,2,1,5
PRK,2000,3,0,1,4
PRK,2004,1,0,4,5
PRK,2008,2,2,2,6
PRK,2012,3,4,0,7
PRK,2016,2,2,3,7
PUR,1948,1,0,0,1
PUR,1976,1,0,0,1
PUR,1984,1,0,1,2
PUR,1992,1,0,0,1
PUR,1996,1,0,0,1
PUR,2012,1,0,1,2
PUR,2016,0,1,0,1
PUR,2020,0,1,0,1
QAT,1992,1,0,0,1
QAT,2000,1,0,0,1
QAT,2012,1,0,1,2
QAT,2016,0,0,1,1
QAT,2020,2,2,0,4
ROC,2020,27,22,32,81
ROC,2022,17,7,14,38
ROU,1924,1,0,0,1
ROU,1936,0,0,1,1
ROU,1952,2,1,1,4
ROU,1956,5,6,3,14
ROU,1960,6,3,1,10
ROU,1964,7,2,4,13
ROU,1968,7,5,6,18
ROU,1972,8,3,7,18
ROU,1976,15,4,10,29
ROU,1980,14,7,7,28
ROU,1984,17,24,17,58
ROU,1988,6,8,12,26
ROU,1992,8,4,7,19
ROU,1996,10,5,8,23
ROU,2000,10,14,6,30
ROU,2004,6,10,5,21
ROU,2008,4,5,1,10
ROU,2012,1,2,4,7
ROU,2016,2,1,2,5
ROU,2020,0,2,4,6
RSA,1908,0,1,1,2
RSA,1912,0,5,2,7
RSA,1920,3,3,5,11
RSA,1924,1,1,1,3
RSA,1928,2,1,0,3
RSA,1932,3,2,0,5
RSA,1936,0,0,1,1
RSA,1948,1,2,1,4
RSA,1952,4,2,5,11
RSA,1956,4,0,0,4
RSA,1960,2,0,1,3
RSA,1992,0,0,3,3
RSA,1996,1,3,1,5
RSA,2000,3,0,2,5
RSA,2004,3,1,3,7
RSA,2008,0,0,1,1
RSA,2012,1,4,1,6
RSA,2016,2,2,7,11
RSA,2020,0,1,2,3
RUS,1908,0,1,2,3
RUS,1912,3,0,2,5
RUS,1994,4,13,10,27
RUS,1996,16,26,21,63
RUS,1998,3,11,8,22
RUS,2000,29,35,29,93
RUS,2002,4,6,5,15
RUS,2004,37,29,29,95
RUS,2006,9,10,6,25
RUS,2008,26,25,16,67
RUS,2010,11,3,5,19
RUS,2012,30,22,21,73
RUS,2014,10,12,11,33
RUS,2016,20,21,18,59
SAM,2008,0,0,1,1
SCG,1996,2,1,1,4
SCG,2000,1,1,1,3
SCG,2004,0,0,2,2
SEN,1988,0,0,1,1
SGP,1960,0,0,1,1
SGP,2008,0,0,1,1
SGP,2012,2,0,0,2
SGP,2016,0,1,0,1
SLO,1992,3,0,0,3
SLO,1994,3,0,0,3
SLO,1996,0,0,2,2
SLO,2000,0,3,0,3
SLO,2002,1,0,0,1
SLO,2004,3,0,2,5
SLO,2008,2,1,2,5
SLO,2010,1,0,2,3
SLO,2012,3,1,1,5
SLO,2014,4,2,2,8
SLO,2016,1,1,2,4
SLO,2018,1,0,1,2
SLO,2020,1,3,1,5
SLO,2022,2,2,3,7
SMR,2020,2,0,2,4
SRB,2008,2,0,1,3
SRB,2012,2,1,1,4
SRB,2016,2,2,5,9
SRB,2020,5,3,1,9
SRI,1948,0,0,1,1
SRI,2000,0,0,1,1
SUD,2008,0,0,1,1
SUI,1896,0,1,2,3
SUI,1900,1,6,2,9
SUI,1904,2,1,0,3
SUI,1920,7,2,2,11
SUI,1924,12,9,8,29
SUI,1928,5,7,4,16
SUI,1932,0,0,3,3
SUI,1936,5,2,12,19
SUI,1948,8,9,16,33
SUI,1952,10,2,6,18
SUI,1956,2,3,2,7
SUI,1960,4,2,3,9
SUI,1964,1,1,2,4
SUI,1968,8,0,3,11
SUI,1972,4,4,7,15
SUI,1976,4,2,4,10
SUI,1980,3,4,1,8
SUI,1984,5,2,6,13
SUI,1988,7,5,8,20
SUI,1992,2,3,0,5
SUI,1994,2,4,5,11
SUI,1996,0,5,3,8
SUI,1998,3,2,2,7
SUI,2000,2,1,6,9
SUI,2002,7,3,3,13
SUI,2004,4,1,2,7
SUI,2006,6,5,4,15
SUI,2008,4,3,1,8
SUI,2010,3,6,0,9
SUI,2012,0,2,2,4
SUI,2014,2,8,2,12
SUI,2016,2,3,3,8
SUI,2018,4,5,7,16
SUI,2020,7,3,5,15
SUI,2022,5,7,2,14
SUR,1988,0,1,0,1
SUR,1992,1,0,0,1
SVK,1996,1,1,1,3
SVK,2000,1,2,3,6
SVK,2004,2,3,2,7
SVK,2006,0,0,1,1
SVK,2008,0,4,3,7
SVK,2010,1,1,1,3
SVK,2012,4,0,1,5
SVK,2014,0,1,0,1
SVK,2016,0,3,2,5
SVK,2018,0,1,2,3
SVK,2020,1,1,2,4
SVK,2022,1,1,0,2
SWE,1900,1,0,0,1
SWE,1908,12,8,6,26
SWE,1912,18,24,26,68
SWE,1920,25,19,20,64
SWE,1924,12,5,14,31
SWE,1928,13,8,8,29
SWE,1932,10,10,7,27
SWE,1936,11,7,8,26
SWE,1948,20,22,14,56
SWE,1952,14,12,12,38
SWE,1956,10,7,9,26
SWE,1960,5,5,4,14
SWE,1964,6,6,5,17
SWE,1968,4,5,3,12
SWE,1972,8,5,8,21
SWE,1976,2,5,1,8
SWE,1980,8,6,3,17
SWE,1984,8,7,14,29
SWE,1988,10,4,5,19
SWE,1992,7,2,9,18
SWE,1994,0,2,1,3
SWE,1996,2,3,5,10
SWE,1998,1,0,2,3
SWE,2000,3,4,6,13
SWE,2002,5,0,2,7
SWE,2004,2,5,2,9
SWE,2006,5,9,2,16
SWE,2008,2,0,5,7
SWE,2010,4,5,3,12
SWE,2012,3,2,4,9
SWE,2014,8,2,7,17
SWE,2016,3,2,6,11
SWE,2018,1,7,7,15
SWE,2020,0,3,7,10
SWE,2022,6,8,6,20
SYR,1984,0,0,1,1
SYR,1996,0,1,0,1
SYR,2004,1,0,0,1
SYR,2020,1,0,0,1
TAN,1980,0,0,2,2
TCH,1920,3,0,0,3
TCH,1924,5,1,4,10
TCH,1928,3,2,5,10
TCH,1932,1,1,2,4
TCH,1936,0,3,5,8
TCH,1948,3,7,4,14
TCH,1952,2,7,4,13
TCH,1956,1,1,5,7
TCH,1960,3,4,3,10
TCH,1964,5,5,6,16
TCH,1968,5,8,4,17
TCH,1972,4,3,4,11
TCH,1976,4,2,3,9
TCH,1980,11,2,3,16
TCH,1984,4,0,2,6
TCH,1988,5,3,5,13
TCH,1992,4,4,3,11
TGA,1996,0,0,1,1
THA,1976,1,0,0,1
THA,1984,0,0,1,1
THA,1988,1,0,0,1
THA,1992,1,0,0,1
THA,1996,1,1,0,2
THA,2000,2,1,0,3
THA,2004,4,3,1,8
THA,2008,2,2,2,6
THA,2012,2,0,2,4
THA,2016,2,2,2,6
THA,2020,1,1,0,2
TJK,2008,1,0,1,2
TJK,2012,1,0,0,1
TJK,2016,0,1,0,1
TKM,2020,0,0,1,1
TOG,2008,1,0,0,1
TPE,1960,0,0,1,1
TPE,1968,1,0,0,1
TPE,1984,1,0,0,1
TPE,1992,0,0,1,1
TPE,1996,0,0,1,1
TPE,2000,4,0,1,5
TPE,2004,1,2,2,5
TPE,2008,2,1,1,4
TPE,2012,1,1,0,2
TPE,2016,2,1,0,3
TPE,2020,7,3,4,14
TTO,1948,0,0,1,1
TTO,1952,2,0,0,2
TTO,1964,2,0,1,3
TTO,1976,0,1,0,1
TTO,1996,2,0,0,2
TTO,2000,1,0,1,2
TTO,2004,1,0,0,1
TTO,2008,0,1,1,2
TTO,2012,2,1,1,4
TTO,2016,1,0,0,1
TUN,1964,1,0,1,2
TUN,1968,1,1,0,2
TUN,1972,0,0,1,1
TUN,1996,1,0,0,1
TUN,2008,0,1,0,1
TUN,2012,1,2,0,3
TUN,2016,3,0,0,3
TUN,2020,0,1,1,2
TUR,1936,1,1,0,2
TUR,1948,2,6,4,12
TUR,1952,1,2,0,3
TUR,1956,2,3,2,7
TUR,1960,0,7,2,9
TUR,1964,1,2,3,6
TUR,1968,0,2,0,2
TUR,1972,0,0,1,1
TUR,1984,3,0,0,3
TUR,1988,0,1,1,2
TUR,1992,2,2,2,6
TUR,1996,1,4,1,6
TUR,2000,2,3,0,5
TUR,2004,4,3,3,10
TUR,2008,3,1,1,5
TUR,2012,1,1,1,3
TUR,2016,4,1,3,8
TUR,2020,9,2,2,13
UAE,2004,0,1,0,1
UAE,2016,1,0,0,1
UAR,1960,1,0,1,2
UGA,1968,1,0,1,2
UGA,1972,0,1,1,2
UGA,1980,0,0,1,1
UGA,1996,1,0,0,1
UGA,2012,0,1,0,1
UGA,2020,1,2,1,4
UKR,1994,1,1,0,2
UKR,1996,13,10,2,25
UKR,1998,0,0,1,1
UKR,2000,12,3,10,25
UKR,2004,9,8,6,23
UKR,2006,3,0,0,3
UKR,2008,12,7,4,23
UKR,2012,10,5,4,19
UKR,2014,1,1,0,2
UKR,2016,5,2,5,12
UKR,2018,0,1,0,1
UKR,2020,14,1,7,22
UKR,2022,0,0,1,1
URS,1952,19,22,31,72
URS,1956,38,46,35,119
URS,1960,41,54,35,130
URS,1964,41,44,40,125
URS,1968,35,37,38,110
URS,1972,25,65,33,123
URS,1976,44,68,50,162
URS,1980,54,96,78,228
URS,1984,12,7,12,31
URS,1988,57,71,44,172
URU,1924,0,1,0,1
URU,1928,0,1,0,1
URU,1932,1,0,0,1
URU,1948,2,0,1,3
URU,1952,3,0,0,3
URU,1956,1,0,0,1
URU,1964,1,0,0,1
URU,2000,0,0,1,1
USA,1896,2,11,7,20
USA,1900,15,19,14,48
USA,1904,81,79,81,241
USA,1908,12,23,12,47
USA,1912,19,25,19,63
USA,1920,27,42,27,96
USA,1924,28,50,30,108
USA,1928,19,25,20,64
USA,1932,33,50,37,120
USA,1936,15,26,20,61
USA,1948,23,43,32,98
USA,1952,18,44,28,90
USA,1956,19,36,29,84
USA,1960,21,37,25,83
USA,1964,34,37,31,102
USA,1968,36,47,34,117
USA,1972,34,36,33,103
USA,1976,31,37,40,108
USA,1980,2,6,4,12
USA,1984,30,91,68,189
USA,1988,32,42,34,108
USA,1992,41,46,41,128
USA,1994,2,6,5,13
USA,1996,25,46,35,106
USA,1998,5,6,4,15
USA,2000,35,40,27,102
USA,2002,12,11,14,37
USA,2004,28,38,40,106
USA,2006,7,9,11,27
USA,2008,38,39,39,116
USA,2010,14,9,16,39
USA,2012,33,50,29,112
USA,2014,11,10,11,32
USA,2016,40,47,40,127
USA,2018,7,10,9,26
USA,2020,34,40,44,118
USA,2022,9,9,10,28
UZB,1994,0,1,0,1
UZB,1996,1,0,1,2
UZB,2000,2,1,1,4
UZB,2004,2,2,1,5
UZB,2008,3,0,1,4
UZB,2012,2,0,0,2
UZB,2016,7,4,2,13
UZB,2020,2,3,0,5
VEN,1952,1,0,0,1
VEN,1960,1,0,0,1
VEN,1968,0,1,0,1
VEN,1976,0,0,1,1
VEN,1980,0,0,1,1
VEN,1984,3,0,0,3
VEN,2004,2,0,0,2
VEN,2008,1,0,0,1
VEN,2012,0,1,0,1
VEN,2016,1,0,2,3
VEN,2020,0,1,3,4
VIE,2000,0,0,1,1
VIE,2008,0,0,1,1
VIE,2016,0,1,1,2
WIF,1960,2,0,0,2
YUG,1924,0,2,0,2
YUG,1928,3,1,1,5
YUG,1936,0,0,1,1
YUG,1948,0,0,2,2
YUG,1952,0,1,2,3
YUG,1956,0,0,3,3
YUG,1960,0,1,1,2
YUG,1964,2,2,1,5
YUG,1968,2,3,3,8
YUG,1972,2,2,1,5
YUG,1976,3,2,3,8
YUG,1980,4,2,4,10
YUG,1984,8,8,6,22
YUG,1988,8,3,7,18
ZAM,1984,1,0,0,1
ZAM,1996,0,0,1,1
ZIM,1980,0,1,0,1
ZIM,2004,1,1,1,3
ZIM,2008,0,1,3,4
